{
  "generatedAt": "2026-07-01T13:18:26.505Z",
  "totalQuestions": 840,
  "domains": 10,
  "levels": 17,
  "domainTotals": {
    "人文社会科学": 84,
    "化学": 87,
    "医歯薬学": 80,
    "地学": 79,
    "工学": 87,
    "情報・計算機科学": 84,
    "数学": 81,
    "物理": 87,
    "生物": 89,
    "農学": 82
  },
  "levelTotals": {
    "100": 50,
    "150": 0,
    "200": 55,
    "250": 50,
    "300": 68,
    "350": 50,
    "400": 83,
    "450": 50,
    "500": 49,
    "550": 51,
    "600": 91,
    "650": 54,
    "700": 61,
    "750": 41,
    "800": 47,
    "850": 0,
    "900": 40
  },
  "matrix": {
    "人文社会科学": {
      "100": 5,
      "150": 0,
      "200": 5,
      "250": 5,
      "300": 5,
      "350": 5,
      "400": 9,
      "450": 5,
      "500": 6,
      "550": 6,
      "600": 10,
      "650": 6,
      "700": 5,
      "750": 4,
      "800": 4,
      "850": 0,
      "900": 4
    },
    "化学": {
      "100": 5,
      "150": 0,
      "200": 5,
      "250": 5,
      "300": 6,
      "350": 5,
      "400": 10,
      "450": 5,
      "500": 5,
      "550": 5,
      "600": 16,
      "650": 4,
      "700": 4,
      "750": 4,
      "800": 4,
      "850": 0,
      "900": 4
    },
    "医歯薬学": {
      "100": 5,
      "150": 0,
      "200": 5,
      "250": 5,
      "300": 8,
      "350": 5,
      "400": 6,
      "450": 5,
      "500": 4,
      "550": 4,
      "600": 4,
      "650": 9,
      "700": 8,
      "750": 4,
      "800": 4,
      "850": 0,
      "900": 4
    },
    "地学": {
      "100": 5,
      "150": 0,
      "200": 6,
      "250": 5,
      "300": 5,
      "350": 5,
      "400": 7,
      "450": 5,
      "500": 5,
      "550": 5,
      "600": 6,
      "650": 5,
      "700": 8,
      "750": 4,
      "800": 4,
      "850": 0,
      "900": 4
    },
    "工学": {
      "100": 5,
      "150": 0,
      "200": 6,
      "250": 5,
      "300": 6,
      "350": 5,
      "400": 14,
      "450": 5,
      "500": 6,
      "550": 5,
      "600": 8,
      "650": 4,
      "700": 6,
      "750": 4,
      "800": 4,
      "850": 0,
      "900": 4
    },
    "情報・計算機科学": {
      "100": 5,
      "150": 0,
      "200": 6,
      "250": 5,
      "300": 8,
      "350": 5,
      "400": 6,
      "450": 5,
      "500": 5,
      "550": 6,
      "600": 5,
      "650": 8,
      "700": 7,
      "750": 5,
      "800": 4,
      "850": 0,
      "900": 4
    },
    "数学": {
      "100": 5,
      "150": 0,
      "200": 5,
      "250": 5,
      "300": 5,
      "350": 5,
      "400": 5,
      "450": 4,
      "500": 4,
      "550": 4,
      "600": 10,
      "650": 4,
      "700": 9,
      "750": 4,
      "800": 8,
      "850": 0,
      "900": 4
    },
    "物理": {
      "100": 5,
      "150": 0,
      "200": 5,
      "250": 5,
      "300": 5,
      "350": 5,
      "400": 11,
      "450": 6,
      "500": 5,
      "550": 5,
      "600": 11,
      "650": 4,
      "700": 5,
      "750": 4,
      "800": 7,
      "850": 0,
      "900": 4
    },
    "生物": {
      "100": 5,
      "150": 0,
      "200": 5,
      "250": 5,
      "300": 11,
      "350": 5,
      "400": 10,
      "450": 5,
      "500": 4,
      "550": 4,
      "600": 14,
      "650": 4,
      "700": 5,
      "750": 4,
      "800": 4,
      "850": 0,
      "900": 4
    },
    "農学": {
      "100": 5,
      "150": 0,
      "200": 7,
      "250": 5,
      "300": 9,
      "350": 5,
      "400": 5,
      "450": 5,
      "500": 5,
      "550": 7,
      "600": 7,
      "650": 6,
      "700": 4,
      "750": 4,
      "800": 4,
      "850": 0,
      "900": 4
    }
  },
  "bias": {
    "idealPerDomainLevel": 4.94,
    "maxCountInOneCell": 16,
    "emptyDomainLevelCells": 20,
    "levelGini": 0.22773109243697479,
    "domainLevelStdDev": 2.6561933893825014
  }
}
