{
  "generatedAt": "2026-06-30T15:32:40.903Z",
  "totalQuestions": 640,
  "domains": 10,
  "levels": 17,
  "domainTotals": {
    "人文社会科学": 64,
    "化学": 67,
    "医歯薬学": 60,
    "地学": 59,
    "工学": 67,
    "情報・計算機科学": 64,
    "数学": 61,
    "物理": 67,
    "生物": 69,
    "農学": 62
  },
  "levelTotals": {
    "100": 30,
    "150": 0,
    "200": 40,
    "250": 32,
    "300": 57,
    "350": 33,
    "400": 71,
    "450": 33,
    "500": 35,
    "550": 37,
    "600": 81,
    "650": 43,
    "700": 51,
    "750": 30,
    "800": 37,
    "850": 0,
    "900": 30
  },
  "matrix": {
    "人文社会科学": {
      "100": 3,
      "150": 0,
      "200": 3,
      "250": 3,
      "300": 4,
      "350": 3,
      "400": 8,
      "450": 3,
      "500": 5,
      "550": 5,
      "600": 9,
      "650": 5,
      "700": 4,
      "750": 3,
      "800": 3,
      "850": 0,
      "900": 3
    },
    "化学": {
      "100": 3,
      "150": 0,
      "200": 3,
      "250": 4,
      "300": 5,
      "350": 4,
      "400": 9,
      "450": 3,
      "500": 3,
      "550": 3,
      "600": 15,
      "650": 3,
      "700": 3,
      "750": 3,
      "800": 3,
      "850": 0,
      "900": 3
    },
    "医歯薬学": {
      "100": 3,
      "150": 0,
      "200": 3,
      "250": 3,
      "300": 7,
      "350": 3,
      "400": 5,
      "450": 3,
      "500": 3,
      "550": 3,
      "600": 3,
      "650": 8,
      "700": 7,
      "750": 3,
      "800": 3,
      "850": 0,
      "900": 3
    },
    "地学": {
      "100": 3,
      "150": 0,
      "200": 5,
      "250": 4,
      "300": 4,
      "350": 3,
      "400": 6,
      "450": 4,
      "500": 3,
      "550": 3,
      "600": 5,
      "650": 3,
      "700": 7,
      "750": 3,
      "800": 3,
      "850": 0,
      "900": 3
    },
    "工学": {
      "100": 3,
      "150": 0,
      "200": 5,
      "250": 3,
      "300": 5,
      "350": 3,
      "400": 13,
      "450": 3,
      "500": 5,
      "550": 3,
      "600": 7,
      "650": 3,
      "700": 5,
      "750": 3,
      "800": 3,
      "850": 0,
      "900": 3
    },
    "情報・計算機科学": {
      "100": 3,
      "150": 0,
      "200": 5,
      "250": 3,
      "300": 7,
      "350": 4,
      "400": 5,
      "450": 3,
      "500": 3,
      "550": 5,
      "600": 4,
      "650": 7,
      "700": 6,
      "750": 3,
      "800": 3,
      "850": 0,
      "900": 3
    },
    "数学": {
      "100": 3,
      "150": 0,
      "200": 3,
      "250": 3,
      "300": 4,
      "350": 3,
      "400": 3,
      "450": 3,
      "500": 3,
      "550": 3,
      "600": 9,
      "650": 3,
      "700": 8,
      "750": 3,
      "800": 7,
      "850": 0,
      "900": 3
    },
    "物理": {
      "100": 3,
      "150": 0,
      "200": 4,
      "250": 3,
      "300": 3,
      "350": 3,
      "400": 10,
      "450": 5,
      "500": 4,
      "550": 3,
      "600": 10,
      "650": 3,
      "700": 4,
      "750": 3,
      "800": 6,
      "850": 0,
      "900": 3
    },
    "生物": {
      "100": 3,
      "150": 0,
      "200": 3,
      "250": 3,
      "300": 10,
      "350": 3,
      "400": 9,
      "450": 3,
      "500": 3,
      "550": 3,
      "600": 13,
      "650": 3,
      "700": 4,
      "750": 3,
      "800": 3,
      "850": 0,
      "900": 3
    },
    "農学": {
      "100": 3,
      "150": 0,
      "200": 6,
      "250": 3,
      "300": 8,
      "350": 4,
      "400": 3,
      "450": 3,
      "500": 3,
      "550": 6,
      "600": 6,
      "650": 5,
      "700": 3,
      "750": 3,
      "800": 3,
      "850": 0,
      "900": 3
    }
  },
  "bias": {
    "idealPerDomainLevel": 3.76,
    "maxCountInOneCell": 15,
    "emptyDomainLevelCells": 20,
    "levelGini": 0.2757352941176471,
    "domainLevelStdDev": 2.497749852419074
  }
}
